నీ సన్నిదే నా తోడుగ - nee sannidhe naa toduga
తరాలు మారినా - taralu marina
శరణని వేడితినయ్యా - saranani vedithinayya
నా ప్రాణమా స్తుతియించుమా - naa pranama sthuthiyinchuma
పరిశుద్ధాత్ముడా - Parishudhatmuda
కలువరి సిలువలో - Kaluvari siluvalo
ఎంతో మంచి దేవుడవో యేసయ్యా - entho manchi devudavo yesayya
విజ్ఞాపన ఆలకించె దేవుడు - vignapana alakinche devudu
అడుగుపెట్టు ప్రతిస్థలము - adugupettu prathi sthalamu
నీ నామమెంతో - nee namamentho
భయపడకు - భయపడకని - bhayapadaku bhayapadakani
నీవు తప్ప దేవుడు - neevu tappa devudu naku
రుచి చూసి యెరిగితిని - ruchi chusi erigithini
విజ్ఞాపనా విజ్ఞాపనా - vignapana vignapana
ఈ విధముగనీ - ee vidhamuga nee
ఉన్నతమైన దర్శనము - unnathamina darshanamu
కీర్తనీయుడా - keerthaneeyuda
యెహోవా నా కాపరి - yehova naa kapari
ఎవరు నన్ను చెయి విడచినా - evaru nannu cheyi vidichina
యేసయ్యా పుట్టినరోజు - yesayya puttinaroju
లెమ్ము లెమ్ము సోదరా - lemmu lemmu sodara
మనుష్యులు చేసినా దేవుళ్ళు - manushulu chesina devullu
కనికరించుమయా - kanikarinchumayya
ఓ ! సంఘమా మేలుకో - oo sangama meluko
నూతన గీతాలు - nuthana geethalatho
ఆరాధనీయుడా - aaradhaneeyuda
విజ్ఞాపనా- విజ్ఞాపనా - vignapana vignapana
నీ పదసేవయే - nee padasevaye
ఎంతైనా నమ్మదగిన - entaina nammadagina
యజమానుడా - యేసయ్య - yajamanuda yesayya
నిన్నే నమ్ముకున్నానయా - ninne nammukunnanaya
ఎంత ప్రేమ యేసయ్య - Enta prema Yesayya
స్మరియించెదను - smariyinchedanu
నిన్ను స్తుతియించుటకు - ninnu stutiyinchutaku
లోకాన పండుగ - lokana panduga
తిరిగిరాని జీవితం - tirigirani jivitam
సమర్పణ కలిగి - Samarpana kaligi
సిలువలో పలికిన - siluvalo palikina
యవ్వనుడా యేసంటే - yavvanuda yesante
దినములు చెడ్డవి - dinamulu cheddavi
అనుకూల సమయము - Anukoola samayamu
హృదయ ఆసీనుడా - hrudaya asinuda
ఓ సోమరీ - O Somari
గడచిన కాలము - gadachina kaalamu
ఆశ కలిగి - aasha kaligi
విజ్ఞాపన చేయరే - vignapana cheyare
పరలోకము నుండి - paralokamu nundi
దేవా నీ కొరకు - Deva nee koraku
నీరు కట్టిన తోటవలె - neeru kattina totavale
సైన్యములకు అధిపతివయ్య - Sainyamulaku Adhipativayya
నా దేశమును - naa deshamunu
యవ్వనులారా కదలిరండి - yavvanulara kadili randi
హైలెస్సా నా పడవ - hilessa naa padava
క్రొత్త పాట పాడెదనయ్యయా -  Krotha paata paadedanayya
అందరిలో నా ప్రభువు - andarilo naa prabhuvu